SA3 Names,TotalM,Male,Female,Population,popPer10k
Queanbeyan,4179,32664,32122,64786,645
Snowy Mountains,593,10674,10046,20720,286
South Coast,1701,37632,39101,76733,222
Goulburn - Mulwaree,1236,19335,19072,38407,322
Young - Yass,991,18787,19369,38156,260
Gosford,12348,86375,92052,178427,692
Wyong,5942,81600,86567,168167,353
Bathurst,1591,24775,24370,49145,324
Lachlan Valley,1093,27228,27455,54683,200
Lithgow - Mudgee,977,24136,23731,47867,204
Orange,2162,30057,31205,61262,353
Clarence Valley,1054,26823,26846,53669,196
Coffs Harbour,5110,44679,47787,92466,553
Bourke - Cobar - Coonamble,453,10850,10754,21604,210
Broken Hill and Far West,353,9753,10128,19881,178
Dubbo,2800,36712,37368,74080,378
Lower Hunter,2077,49527,48403,97930,212
Maitland,3457,42401,44621,87022,397
Port Stephens,2175,37701,38712,76413,285
Upper Hunter,910,15516,15073,30589,297
Dapto - Port Kembla,3708,39249,40573,79822,465
Illawarra Catchment Reserve,0,5,0,5,0
Kiama - Shellharbour,3341,48441,50814,99255,337
Wollongong,9343,66376,68383,134759,693
Great Lakes,663,16139,17170,33309,199
Kempsey - Nambucca,829,25394,25762,51156,162
Lord Howe Island,24,220,232,452,531
Port Macquarie,2927,41583,45192,86775,337
Taree - Gloucester,1149,27996,29349,57345,200
Albury,3336,32640,34406,67046,498
Lower Murray,214,6720,6336,13056,164
Upper Murray exc. Albury,696,21550,21897,43447,160
Armidale,2044,18111,19424,37535,545
Inverell - Tenterfield,746,19092,19633,38725,193
Moree - Narrabri,467,12412,12304,24716,189
Tamworth - Gunnedah,2496,41646,42933,84579,295
Lake Macquarie - East,4286,61622,64868,126490,339
Lake Macquarie - West,2892,41502,43523,85025,340
Newcastle,10226,87900,91097,178997,571
Richmond Valley - Coastal,4621,42285,45487,87772,526
Richmond Valley - Hinterland,1813,35340,36554,71894,252
Tweed Valley,3939,46804,50586,97390,404
Griffith - Murrumbidgee (West),2733,24857,24700,49557,551
Tumut - Tumbarumba,420,7516,7412,14928,281
Wagga Wagga,5016,48977,50189,99166,506
Shoalhaven,3182,53607,54719,108326,294
Southern Highlands,2484,25301,27378,52679,472
Baulkham Hills,35883,75876,78890,154766,2319
Dural - Wisemans Ferry,2112,14073,13842,27915,757
Hawkesbury,616,12706,12301,25007,246
Rouse Hill - McGraths Hill,12824,28181,28503,56684,2262
Blacktown,32202,71682,70919,142601,2258
Blacktown - North,46029,71612,71161,142773,3224
Mount Druitt,22264,56813,58811,115624,1926
Botany,10936,29443,29336,58779,1861
Marrickville - Sydenham - Petersham,5298,27216,27559,54775,967
Sydney Inner City,38870,113854,103946,217800,1785
Eastern Suburbs - North,17245,60705,66464,127169,1356
Eastern Suburbs - South,19693,65373,68868,134241,1467
Bankstown,29305,92113,94123,186236,1574
Canterbury,24738,72154,68936,141090,1753
Hurstville,23135,64901,66966,131867,1754
Kogarah - Rockdale,24223,72435,73478,145913,1660
Canada Bay,13518,41593,45118,86711,1559
Leichhardt,6280,27004,29390,56394,1114
Strathfield - Burwood - Ashfield,28324,79907,81757,161664,1752
Chatswood - Lane Cove,23970,56882,60576,117458,2041
Hornsby,21043,43058,44393,87451,2406
Ku-ring-gai,26011,59985,64374,124359,2092
North Sydney - Mosman,15542,44252,50524,94776,1640
Manly,7265,20957,22218,43175,1683
Pittwater,5571,30969,32511,63480,878
Warringah,22003,77000,79897,156897,1402
Camden,4289,35860,37715,73575,583
Campbelltown (NSW),29611,87381,90494,177875,1665
Wollondilly,1008,22925,22909,45834,220
Blue Mountains,2987,37767,40183,77950,383
Blue Mountains - South,0,8,0,8,0
Penrith,14431,78199,81110,159309,906
Richmond - Windsor,1191,18860,19149,38009,313
St Marys,6189,28372,28419,56791,1090
Auburn,27291,54564,48983,103547,2636
Carlingford,19240,36821,37200,74021,2599
Merrylands - Guildford,31740,83155,80663,163818,1938
Parramatta,45059,77045,75080,152125,2962
Pennant Hills - Epping,14576,26486,28351,54837,2658
Ryde - Hunters Hill,32961,71893,75310,147203,2239
Bringelly - Green Valley,24498,71080,72001,143081,1712
Fairfield,46289,96126,99043,195169,2372
Liverpool,30471,67723,68452,136175,2238
Cronulla - Miranda - Caringbah,8419,57531,60336,117867,714
Sutherland - Menai - Heathcote,7710,54723,57018,111741,690
Migratory - Offshore - Shipping (NSW),0,0,0,0,0
No usual address (NSW),459,6375,4997,11372,404
Ballarat,5077,55982,60219,116201,437
Creswick - Daylesford - Ballan,840,15481,15497,30978,271
Maryborough - Pyrenees,367,13582,13170,26752,137
Bendigo,5294,49462,53577,103039,514
Heathcote - Castlemaine - Kyneton,1526,26167,26336,52503,291
Loddon - Elmore,220,6168,6053,12221,180
Barwon - West,536,11359,11121,22480,238
Geelong,14929,103468,108519,211987,704
Surf Coast - Bellarine Peninsula,3834,45240,48180,93420,410
Upper Goulburn Valley,1607,30066,29941,60007,268
Wangaratta - Benalla,1131,23482,24972,48454,233
Wodonga - Alpine,2909,37620,38853,76473,380
Baw Baw,1820,28108,29668,57776,315
Gippsland - East,1220,24009,24822,48831,250
Gippsland - South West,1815,35040,36507,71547,254
Latrobe Valley,2420,37742,39423,77165,314
Wellington,1126,22933,22598,45531,247
Brunswick - Coburg,7846,43136,46737,89873,873
Darebin - South,3830,25272,28000,53272,719
Essendon,7009,33296,35423,68719,1020
Melbourne City,29633,74410,75191,149601,1981
Port Phillip,13206,49717,52243,101960,1295
Stonnington - West,7690,29671,32861,62532,1230
Yarra,9450,44441,46620,91061,1038
Boroondara,23570,80517,87386,167903,1404
Manningham - West,22075,47425,50961,98386,2244
Whitehorse - West,20893,51864,55325,107189,1949
Bayside,10771,48378,52930,101308,1063
Glen Eira,23582,75881,80593,156474,1507
Kingston,13757,58875,63821,122696,1121
Stonnington - East,3995,20222,21944,42166,947
Banyule,12543,61405,64835,126240,994
Darebin - North,10753,46887,48409,95296,1128
Nillumbik - Kinglake,3930,33311,33791,67102,586
Whittlesea - Wallan,43671,125279,126744,252023,1733
Keilor,4048,30112,31572,61684,656
Macedon Ranges,1038,16345,16619,32964,315
Moreland - North,11993,39863,40679,80542,1489
Sunbury,3133,22091,22966,45057,695
Tullamarine - Broadmeadows,52498,102527,101540,204067,2573
Knox,25726,77961,81180,159141,1617
Manningham - East,2757,12924,13457,26381,1045
Maroondah,15181,55463,59114,114577,1325
Whitehorse - East,12919,30431,32502,62933,2053
Yarra Ranges,8881,76764,78492,155256,572
Cardinia,14748,58360,59981,118341,1246
Casey - North,27875,68289,68997,137286,2030
Casey - South,63335,113748,114202,227950,2778
Dandenong,45297,98076,95568,193644,2339
Monash,43288,91189,91650,182839,2368
Brimbank,32562,93284,92785,186069,1750
Hobsons Bay,8620,42182,44406,86588,996
Maribyrnong,11433,42713,42498,85211,1342
Melton - Bacchus Marsh,36043,98729,99709,198438,1816
Wyndham,93615,149962,146783,296745,3155
Frankston,10167,68038,71240,139278,730
Mornington Peninsula,7647,81681,87267,168948,453
Grampians,1835,30363,29974,60337,304
Mildura,2483,28040,28932,56972,436
Murray River - Swan Hill,1292,19246,19013,38259,338
Campaspe,821,19192,19703,38895,211
Moira,620,15234,15286,30520,203
Shepparton,5722,33914,34293,68207,839
Glenelg - Southern Grampians,794,18201,18592,36793,216
Colac - Corangamite,890,19320,19176,38496,231
Warrnambool,1498,25622,27155,52777,284
Migratory - Offshore - Shipping (Vic.),0,36,6,42,0
No usual address (Vic.),444,5170,3915,9085,489
Capalaba,5966,36104,37283,73387,813
Cleveland - Stradbroke,8119,45424,47967,93391,869
Wynnum - Manly,7581,35597,37449,73046,1038
Bald Hills - Everton Park,6388,22302,23824,46126,1385
Chermside,7413,35938,38393,74331,997
Nundah,5041,21406,21562,42968,1173
Sandgate,7856,29654,31519,61173,1284
Carindale,6479,26139,28141,54280,1194
Holland Park - Yeronga,8798,39039,40355,79394,1108
Mt Gravatt,17094,38874,40497,79371,2154
Nathan,4989,19952,19954,39906,1250
Rocklea - Acacia Ridge,18899,33330,34560,67890,2784
Sunnybank,13598,25085,25103,50188,2709
Centenary,4505,16187,16827,33014,1365
Kenmore - Brookfield - Moggill,8579,23476,24257,47733,1797
Sherwood - Indooroopilly,8780,26390,27897,54287,1617
The Gap - Enoggera,5514,26584,27597,54181,1018
Brisbane Inner,13464,44130,43341,87471,1539
Brisbane Inner - East,4817,21715,22659,44374,1086
Brisbane Inner - North,11167,49065,51001,100066,1116
Brisbane Inner - West,5698,29739,30598,60337,944
Cairns - North,6311,28218,29552,57770,1092
Cairns - South,9746,52199,53288,105487,924
Innisfail - Cassowary Coast,1304,18112,17219,35331,369
Port Douglas - Daintree,779,6218,6031,12249,636
Tablelands (East) - Kuranda,1372,21254,21646,42900,320
Darling Downs (West) - Maranoa,1233,22327,21915,44242,279
Darling Downs - East,1315,21538,21321,42859,307
Granite Belt,847,20495,21025,41520,204
Central Highlands (Qld),1303,15003,13853,28856,452
Rockhampton,5228,60741,60624,121365,431
Biloela,438,7463,7051,14514,302
Gladstone,3531,32221,31301,63522,556
Broadbeach - Burleigh,5152,31846,34551,66397,776
Coolangatta,3178,27671,29843,57514,553
Gold Coast - North,7323,32868,36516,69384,1055
Gold Coast Hinterland,1249,9946,10176,20122,621
Mudgeeraba - Tallebudgera,3397,17544,18491,36035,943
Nerang,6152,34312,35372,69684,883
Ormeau - Oxenford,17174,77527,80536,158063,1087
Robina,7145,25375,28528,53903,1326
Southport,7892,31433,33053,64486,1224
Surfers Paradise,4902,22630,22568,45198,1085
Forest Lake - Oxley,15231,39963,38747,78710,1935
Ipswich Hinterland,1466,33908,33390,67298,218
Ipswich Inner,5445,56803,59110,115913,470
Springfield - Redbank,15246,51943,53256,105199,1449
Beaudesert,365,7286,7390,14676,249
Beenleigh,3114,22751,23569,46320,672
Browns Plains,11334,46159,47467,93626,1211
Jimboomba,3167,30600,31035,61635,514
Loganlea - Carbrook,6184,31325,33131,64456,959
Springwood - Kingston,11608,39486,39578,79064,1468
Bowen Basin - North,1353,19539,16279,35818,378
Mackay,6804,61201,60494,121695,559
Whitsunday,1369,11970,11419,23389,585
Bribie - Beachmere,1377,17842,19239,37081,371
Caboolture,3868,38708,41077,79785,485
Caboolture Hinterland,688,8209,6692,14901,462
Narangba - Burpengary,3723,33904,35303,69207,538
Redcliffe,3980,30395,33374,63769,624
The Hills District,7529,44566,45223,89789,839
North Lakes,13013,42722,45344,88066,1478
Strathpine,3387,19659,20186,39845,850
Far North,723,17011,15199,32210,224
Outback - North,1468,15829,14550,30379,483
Outback - South,307,8547,8691,17238,178
Buderim,5941,27803,31155,58958,1008
Caloundra,7195,45868,50442,96310,747
Maroochy,4359,30640,33031,63671,685
Noosa,4569,22391,24264,46655,979
Sunshine Coast Hinterland,3552,28866,30178,59044,602
Nambour,2990,24436,25557,49993,598
Noosa Hinterland,1488,12001,12208,24209,615
Toowoomba,12957,78137,83917,162054,800
Charters Towers - Ayr - Ingham,675,20903,20562,41465,163
Townsville,11635,96239,96585,192824,603
Bundaberg,3111,45971,47827,93798,332
Burnett,945,24996,24678,49674,190
Gympie - Cooloola,1373,26355,26783,53138,258
Hervey Bay,2794,30262,33235,63497,440
Maryborough,909,24119,23508,47627,191
Migratory - Offshore - Shipping (Qld),5,149,28,177,282
No usual address (Qld),533,7861,6807,14668,363
Adelaide City,3423,12770,12259,25029,1368
Adelaide Hills,4233,39184,40539,79723,531
Burnside,7668,21989,24048,46037,1666
Campbelltown (SA),9460,26782,28387,55169,1715
Norwood - Payneham - St Peters,4756,18070,19424,37494,1268
Prospect - Walkerville,3433,14884,15411,30295,1133
Unley,3878,18278,20362,38640,1004
Gawler - Two Wells,1291,18564,19141,37705,342
Playford,10158,49428,50505,99933,1016
Port Adelaide - East,17972,38824,38029,76853,2338
Salisbury,25830,72365,72187,144552,1787
Tea Tree Gully,8690,47477,49178,96655,899
Holdfast Bay,3244,17060,18648,35708,908
Marion,14280,46373,49954,96327,1482
Mitcham,6079,32222,34066,66288,917
Onkaparinga,14194,86451,90077,176528,804
Charles Sturt,13146,57723,60717,118440,1110
Port Adelaide - West,7239,29939,30910,60849,1190
West Torrens,8709,31927,33125,65052,1339
Barossa,946,18939,19036,37975,249
Lower North,453,11372,11319,22691,200
Mid North,520,13495,13673,27168,191
Yorke Peninsula,308,13421,13235,26656,116
Eyre Peninsula and South West,1514,28810,28279,57089,265
Outback - North and East,725,13365,12193,25558,284
Fleurieu - Kangaroo Island,1697,27030,28565,55595,305
Limestone Coast,2367,33741,33115,66856,354
Murray and Mallee,2287,36221,35040,71261,321
Migratory - Offshore - Shipping (SA),0,12,0,12,0
No usual address (SA),158,1873,1506,3379,468
Augusta - Margaret River - Busselton,3920,28080,29249,57329,684
Bunbury,7824,53276,54279,107555,727
Manjimup,879,11911,11949,23860,368
Mandurah,10888,51979,55660,107639,1012
Cottesloe - Claremont,8583,34905,36829,71734,1197
Perth City,16775,55115,55410,110525,1518
Bayswater - Bassendean,11894,41790,42676,84466,1408
Mundaring,3221,22643,21152,43795,735
Swan,26123,73672,74650,148322,1761
Joondalup,28547,79502,81136,160638,1777
Stirling,35174,101037,107110,208147,1690
Wanneroo,48994,102522,105984,208506,2350
Armadale,19487,46604,47583,94187,2069
Belmont - Victoria Park,13812,38172,37142,75314,1834
Canning,26532,49396,49742,99138,2676
Gosnells,32356,63485,62887,126372,2560
Kalamunda,6540,29108,29654,58762,1113
Serpentine - Jarrahdale,3666,16103,16138,32241,1137
South Perth,6266,21275,22177,43452,1442
Cockburn,19771,57054,58771,115825,1707
Fremantle,3805,19324,20592,39916,953
Kwinana,9036,23482,22379,45861,1970
Melville,15618,50918,55210,106128,1472
Rockingham,17639,67085,68591,135676,1300
Albany,3590,30830,31049,61879,580
Wheat Belt - North,2592,28873,27059,55932,463
Wheat Belt - South,718,9908,9448,19356,371
Kimberley,1607,17306,17780,35086,458
East Pilbara,2397,14487,10955,25442,942
West Pilbara,2612,16330,13262,29592,883
Esperance,725,8093,7881,15974,454
Gascoyne,533,4954,4578,9532,559
Goldfields,3382,20641,17624,38265,884
Mid West,2918,27893,27096,54989,531
Migratory - Offshore - Shipping (WA),47,455,58,513,916
No usual address (WA),322,4639,3416,8055,400
Brighton,437,9511,10076,19587,223
Hobart - North East,3085,28816,30350,59166,521
Hobart - North West,5073,28595,29410,58005,875
Hobart - South and West,3050,17648,18997,36645,832
Hobart Inner,5606,26845,28319,55164,1016
Sorell - Dodges Ferry,524,9106,9414,18520,283
Launceston,5804,42323,45021,87344,664
Meander Valley - West Tamar,608,12107,12150,24257,251
North East,778,19905,19694,39599,196
Central Highlands (Tas.),199,6528,5911,12439,160
Huon - Bruny Island,856,10873,10841,21714,394
South East Coast,231,3920,3663,7583,305
Burnie - Ulverstone,1170,24054,25972,50026,234
Devonport,1326,23559,24730,48289,275
West Coast,446,9198,8641,17839,250
Migratory - Offshore - Shipping (Tas.),0,13,0,13,0
No usual address (Tas.),29,758,616,1374,211
Darwin City,4354,13788,13254,27042,1610
Darwin Suburbs,9533,27068,27633,54701,1743
Litchfield,838,11481,9501,20982,399
Palmerston,5023,18401,18775,37176,1351
Alice Springs,3418,18090,18383,36473,937
Barkly,239,2702,2587,5289,452
Daly - Tiwi - West Arnhem,249,8076,7726,15802,158
East Arnhem,310,6440,6361,12801,242
Katherine,742,9580,9158,18738,396
Migratory - Offshore - Shipping (NT),0,83,15,98,0
No usual address (NT),111,1826,1675,3501,317
Belconnen,12480,52533,53530,106063,1177
Canberra East,113,1289,646,1935,584
Gungahlin,19744,43701,43981,87682,2252
North Canberra,6339,30179,31002,61181,1036
South Canberra,3085,15257,16331,31588,977
Tuggeranong,7167,44054,45414,89468,801
Weston Creek,1892,11952,12676,24628,768
Woden Valley,4561,19118,20165,39283,1161
Molonglo,3273,5610,5828,11438,2862
Uriarra - Namadgi,23,328,300,628,366
Migratory - Offshore - Shipping (ACT),0,0,0,0,0
No usual address (ACT),27,336,273,609,443
Christmas Island,114,1006,685,1691,674
Cocos (Keeling) Islands,17,302,292,594,286
Jervis Bay,0,149,158,307,0
Norfolk Island,157,1060,1130,2190,717
Migratory - Offshore - Shipping (OT),0,0,0,0,0
No usual address (OT),0,6,4,10,0
